"filename", "language", "JavaScript", "CSS", "JavaScript JSX", "TypeScript", "TypeScript JSX", "comment", "blank", "total"
"c:\Users\User\Documents\dev\upwork\wekthor-games-webpage\src\app\about\page.jsx", "JavaScript JSX", 0, 0, 118, 0, 0, 1, 2, 121
"c:\Users\User\Documents\dev\upwork\wekthor-games-webpage\src\app\about\page.tsx", "TypeScript JSX", 0, 0, 0, 0, -125, -1, -2, -128
"c:\Users\User\Documents\dev\upwork\wekthor-games-webpage\src\app\account\components\LogoutButton.jsx", "JavaScript JSX", 0, 0, 15, 0, 0, 0, 2, 17
"c:\Users\User\Documents\dev\upwork\wekthor-games-webpage\src\app\account\components\NameEdit.jsx", "JavaScript JSX", 0, 0, 126, 0, 0, 19, 7, 152
"c:\Users\User\Documents\dev\upwork\wekthor-games-webpage\src\app\account\components\PasswordChange.jsx", "JavaScript JSX", 0, 0, 108, 0, 0, 0, 7, 115
"c:\Users\User\Documents\dev\upwork\wekthor-games-webpage\src\app\account\components\UserDetails.jsx", "JavaScript JSX", 0, 0, 47, 0, 0, 8, 8, 63
"c:\Users\User\Documents\dev\upwork\wekthor-games-webpage\src\app\account\components\UserDetails.tsx", "TypeScript JSX", 0, 0, 0, 0, -364, -26, -24, -414
"c:\Users\User\Documents\dev\upwork\wekthor-games-webpage\src\app\account\page.jsx", "JavaScript JSX", 0, 0, 10, 0, 0, 3, 4, 17
"c:\Users\User\Documents\dev\upwork\wekthor-games-webpage\src\app\account\page.tsx", "TypeScript JSX", 0, 0, 0, 0, -12, -1, -3, -16
"c:\Users\User\Documents\dev\upwork\wekthor-games-webpage\src\app\api\auth\[...nextauth]\authOptions.js", "JavaScript", 71, 0, 0, 0, 0, 14, 7, 92
"c:\Users\User\Documents\dev\upwork\wekthor-games-webpage\src\app\api\auth\[...nextauth]\authOptions.ts", "TypeScript", 0, 0, 0, -74, 0, -14, -7, -95
"c:\Users\User\Documents\dev\upwork\wekthor-games-webpage\src\app\api\auth\[...nextauth]\route.js", "JavaScript", 4, 0, 0, 0, 0, 1, 2, 7
"c:\Users\User\Documents\dev\upwork\wekthor-games-webpage\src\app\api\auth\[...nextauth]\route.ts", "TypeScript", 0, 0, 0, -4, 0, -1, -2, -7
"c:\Users\User\Documents\dev\upwork\wekthor-games-webpage\src\app\api\email\route.js", "JavaScript", 36, 0, 0, 0, 0, 45, 11, 92
"c:\Users\User\Documents\dev\upwork\wekthor-games-webpage\src\app\api\email\route.ts", "TypeScript", 0, 0, 0, -36, 0, -6, -5, -47
"c:\Users\User\Documents\dev\upwork\wekthor-games-webpage\src\app\api\recover_password\route.js", "JavaScript", 21, 0, 0, 0, 0, 8, 6, 35
"c:\Users\User\Documents\dev\upwork\wekthor-games-webpage\src\app\api\user\[email]\route.ts", "TypeScript", 0, 0, 0, -14, 0, -5, -5, -24
"c:\Users\User\Documents\dev\upwork\wekthor-games-webpage\src\app\api\user\forgot_password\route.js", "JavaScript", 35, 0, 0, 0, 0, 8, 9, 52
"c:\Users\User\Documents\dev\upwork\wekthor-games-webpage\src\app\api\user\route.js", "JavaScript", 12, 0, 0, 0, 0, 2, 3, 17
"c:\Users\User\Documents\dev\upwork\wekthor-games-webpage\src\app\api\user\route.ts", "TypeScript", 0, 0, 0, -12, 0, -2, -3, -17
"c:\Users\User\Documents\dev\upwork\wekthor-games-webpage\src\app\api\user\update_name\route.js", "JavaScript", 7, 0, 0, 0, 0, 2, 4, 13
"c:\Users\User\Documents\dev\upwork\wekthor-games-webpage\src\app\api\user\update_name\route.ts", "TypeScript", 0, 0, 0, -7, 0, -2, -4, -13
"c:\Users\User\Documents\dev\upwork\wekthor-games-webpage\src\app\api\user\update_password\route.js", "JavaScript", 18, 0, 0, 0, 0, 1, 12, 31
"c:\Users\User\Documents\dev\upwork\wekthor-games-webpage\src\app\api\user\update_password\route.ts", "TypeScript", 0, 0, 0, -18, 0, -1, -12, -31
"c:\Users\User\Documents\dev\upwork\wekthor-games-webpage\src\app\api\user\update_role\route.js", "JavaScript", 10, 0, 0, 0, 0, 1, 6, 17
"c:\Users\User\Documents\dev\upwork\wekthor-games-webpage\src\app\api\user\update_role\route.ts", "TypeScript", 0, 0, 0, -11, 0, -1, -6, -18
"c:\Users\User\Documents\dev\upwork\wekthor-games-webpage\src\app\api\user\verify_email\route.js", "JavaScript", 11, 0, 0, 0, 0, 5, 6, 22
"c:\Users\User\Documents\dev\upwork\wekthor-games-webpage\src\app\api\user\verify_email\route.ts", "TypeScript", 0, 0, 0, -11, 0, -5, -6, -22
"c:\Users\User\Documents\dev\upwork\wekthor-games-webpage\src\app\components\Navbar.jsx", "JavaScript JSX", 0, 0, 113, 0, 0, 17, 6, 136
"c:\Users\User\Documents\dev\upwork\wekthor-games-webpage\src\app\components\Navbar.tsx", "TypeScript JSX", 0, 0, 0, 0, -74, -6, -3, -83
"c:\Users\User\Documents\dev\upwork\wekthor-games-webpage\src\app\components\Notification.jsx", "JavaScript JSX", 0, 0, 49, 0, 0, 8, 9, 66
"c:\Users\User\Documents\dev\upwork\wekthor-games-webpage\src\app\components\Notification.tsx", "TypeScript JSX", 0, 0, 0, 0, -71, 0, -9, -80
"c:\Users\User\Documents\dev\upwork\wekthor-games-webpage\src\app\components\Title.tsx", "TypeScript JSX", 0, 0, 0, 0, -4, 0, -2, -6
"c:\Users\User\Documents\dev\upwork\wekthor-games-webpage\src\app\dashboard\components\ListboxComponent.jsx", "JavaScript JSX", 0, 0, 42, 0, 0, 4, 3, 49
"c:\Users\User\Documents\dev\upwork\wekthor-games-webpage\src\app\dashboard\components\ListboxComponent.tsx", "TypeScript JSX", 0, 0, 0, 0, -39, -1, -2, -42
"c:\Users\User\Documents\dev\upwork\wekthor-games-webpage\src\app\dashboard\components\UserRow.jsx", "JavaScript JSX", 0, 0, 26, 0, 0, 0, 2, 28
"c:\Users\User\Documents\dev\upwork\wekthor-games-webpage\src\app\dashboard\components\UserRow.tsx", "TypeScript JSX", 0, 0, 0, 0, -31, 0, -2, -33
"c:\Users\User\Documents\dev\upwork\wekthor-games-webpage\src\app\dashboard\components\UsersList.jsx", "JavaScript JSX", 0, 0, 18, 0, 0, 0, 2, 20
"c:\Users\User\Documents\dev\upwork\wekthor-games-webpage\src\app\dashboard\components\UsersList.tsx", "TypeScript JSX", 0, 0, 0, 0, -19, 0, -2, -21
"c:\Users\User\Documents\dev\upwork\wekthor-games-webpage\src\app\dashboard\page.jsx", "JavaScript JSX", 0, 0, 8, 0, 0, 1, 2, 11
"c:\Users\User\Documents\dev\upwork\wekthor-games-webpage\src\app\dashboard\page.tsx", "TypeScript JSX", 0, 0, 0, 0, -8, -1, -2, -11
"c:\Users\User\Documents\dev\upwork\wekthor-games-webpage\src\app\forgot_password\[token]\page.jsx", "JavaScript JSX", 0, 0, 35, 0, 0, 0, 3, 38
"c:\Users\User\Documents\dev\upwork\wekthor-games-webpage\src\app\forgot_password\components\ForgotPassword_EmailForm.jsx", "JavaScript JSX", 0, 0, 46, 0, 0, 8, 9, 63
"c:\Users\User\Documents\dev\upwork\wekthor-games-webpage\src\app\forgot_password\components\ForgotPassword_ResetForm.jsx", "JavaScript JSX", 0, 0, 69, 0, 0, 8, 10, 87
"c:\Users\User\Documents\dev\upwork\wekthor-games-webpage\src\app\forgot_password\page.jsx", "JavaScript JSX", 0, 0, 9, 0, 0, 0, 2, 11
"c:\Users\User\Documents\dev\upwork\wekthor-games-webpage\src\app\globals.css", "CSS", 0, 0, 0, 0, 0, -1, -1, -2
"c:\Users\User\Documents\dev\upwork\wekthor-games-webpage\src\app\layout.jsx", "JavaScript JSX", 0, 0, 30, 0, 0, 2, 4, 36
"c:\Users\User\Documents\dev\upwork\wekthor-games-webpage\src\app\layout.tsx", "TypeScript JSX", 0, 0, 0, 0, -49, -4, -5, -58
"c:\Users\User\Documents\dev\upwork\wekthor-games-webpage\src\app\login\components\LoginForm.jsx", "JavaScript JSX", 0, 0, 76, 0, 0, 0, 5, 81
"c:\Users\User\Documents\dev\upwork\wekthor-games-webpage\src\app\login\components\LoginForm.tsx", "TypeScript JSX", 0, 0, 0, 0, -88, -5, -10, -103
"c:\Users\User\Documents\dev\upwork\wekthor-games-webpage\src\app\login\page.jsx", "JavaScript JSX", 0, 0, 9, 0, 0, 0, 2, 11
"c:\Users\User\Documents\dev\upwork\wekthor-games-webpage\src\app\login\page.tsx", "TypeScript JSX", 0, 0, 0, 0, -9, 0, -2, -11
"c:\Users\User\Documents\dev\upwork\wekthor-games-webpage\src\app\page.jsx", "JavaScript JSX", 0, 0, 128, 0, 0, 2, 1, 131
"c:\Users\User\Documents\dev\upwork\wekthor-games-webpage\src\app\page.tsx", "TypeScript JSX", 0, 0, 0, 0, -128, -2, -1, -131
"c:\Users\User\Documents\dev\upwork\wekthor-games-webpage\src\app\signup\components\SignUpForm.jsx", "JavaScript JSX", 0, 0, 165, 0, 0, 17, 15, 197
"c:\Users\User\Documents\dev\upwork\wekthor-games-webpage\src\app\signup\components\SignUpForm.tsx", "TypeScript JSX", 0, 0, 0, 0, -113, -5, -5, -123
"c:\Users\User\Documents\dev\upwork\wekthor-games-webpage\src\app\signup\page.jsx", "JavaScript JSX", 0, 0, 9, 0, 0, 0, 2, 11
"c:\Users\User\Documents\dev\upwork\wekthor-games-webpage\src\app\signup\page.tsx", "TypeScript JSX", 0, 0, 0, 0, -9, 0, -2, -11
"c:\Users\User\Documents\dev\upwork\wekthor-games-webpage\src\index.js", "JavaScript", 160, 0, 0, 0, 0, 93, 21, 274
"c:\Users\User\Documents\dev\upwork\wekthor-games-webpage\src\index.ts", "TypeScript", 0, 0, 0, -137, 0, -14, -18, -169
"c:\Users\User\Documents\dev\upwork\wekthor-games-webpage\src\middleware.js", "JavaScript", 16, 0, 0, 0, 0, 6, 5, 27
"c:\Users\User\Documents\dev\upwork\wekthor-games-webpage\src\middleware.ts", "TypeScript", 0, 0, 0, -18, 0, -6, -5, -29
"c:\Users\User\Documents\dev\upwork\wekthor-games-webpage\src\models\PasswordRecoverToken.js", "JavaScript", 16, 0, 0, 0, 0, 0, 4, 20
"c:\Users\User\Documents\dev\upwork\wekthor-games-webpage\src\models\User.js", "JavaScript", 27, 0, 0, 0, 0, 4, 6, 37
"c:\Users\User\Documents\dev\upwork\wekthor-games-webpage\src\models\User.ts", "TypeScript", 0, 0, 0, -39, 0, -5, -7, -51
"c:\Users\User\Documents\dev\upwork\wekthor-games-webpage\src\models\VerificationCode.js", "JavaScript", 17, 0, 0, 0, 0, 0, 4, 21
"c:\Users\User\Documents\dev\upwork\wekthor-games-webpage\src\models\VerificationCode.ts", "TypeScript", 0, 0, 0, -17, 0, 0, -4, -21
"c:\Users\User\Documents\dev\upwork\wekthor-games-webpage\src\mongo_client.js", "JavaScript", 11, 0, 0, 0, 0, 4, 8, 23
"c:\Users\User\Documents\dev\upwork\wekthor-games-webpage\src\mongo_client.ts", "TypeScript", 0, 0, 0, -11, 0, -4, -8, -23
"c:\Users\User\Documents\dev\upwork\wekthor-games-webpage\src\mongoose.js", "JavaScript", 18, 0, 0, 0, 0, 8, 6, 32
"c:\Users\User\Documents\dev\upwork\wekthor-games-webpage\src\mongoose.ts", "TypeScript", 0, 0, 0, -18, 0, -8, -6, -32
"c:\Users\User\Documents\dev\upwork\wekthor-games-webpage\src\types\next-auth.d.ts", "TypeScript", 0, 0, 0, -19, 0, -1, -9, -29
"c:\Users\User\Documents\dev\upwork\wekthor-games-webpage\src\utils\hash.js", "JavaScript", 10, 0, 0, 0, 0, 2, 2, 14
"c:\Users\User\Documents\dev\upwork\wekthor-games-webpage\src\utils\hash.ts", "TypeScript", 0, 0, 0, -33, 0, -2, -3, -38
"Total", "-", 500, 0, 1256, -479, -1143, 172, 42, 348